00000000000000000000000000000000000000000000000000516
00000000000000000000000000000000000000000000000000324
00000000000000000000000000000000000000000000000000324
00000000000000000000000000000000000000000000000000324
00000000000000000000000000000000000000000000000000324
0000000000000000000000000000000511111111600000000ea24
0000000000000000000000000000000322222222bd111111ca224
00000000000000000000000000000003222222222222222222224
000000000000000000000000000000ea222222222222222222224
00000000000000000000511111111ca2222222222222222222224
78900000078900000000322222222222222222222222222222224
00000000000000000000322222222222222222222222222222224
00000000000000000000giiiiiiiiiiiiiiiiiiiiiiiiiiiiiiih